11111111111
10100001011
10000000001
11100010111
11111111111